%%%%%%%%%%%%%%%%%%%%%%%%%%%%%%%%%%%%
% .                               P%
% %%%%%%%%%%%%%%%%%%%%%%% %%%%%%%% %
% %%   %   % .    %%%%%%%   %%     %
% %% % % % % %%%% %%%%%%%%%.%% %%%%%
% %% % % % %             %% %%     %
% %% % % % % % %%%%  %%%    %%%%%% %
% %  % % %   %    %% %%%%%%%%      %
% %% % % %%%%%%%% %%        %% %%%%%
% %% %   %%       %%%%%%%%% %%     %
%    %%%%%% %%%%%%%      %% %%%%%% %
%%%%%%      %       %%%% %% %      %
%      %%%%%% %%%%% %    %% %% %%%%%
% %%%%%%      %       %%%%% %%     %
%        %%%%%% %%%%%%%%%%% %%  %% %
%%%%%%%%%%                  %%%%%% %
%.         %%%%%%%%%%%%%%%%       .%
%%%%%%%%%%%%%%%%%%%%%%%%%%%%%%%%%%%%